Barium: Ba
Plutonium: Pu
Carbon: C
Vanadium: V
Tantalum: Ta
Inconel
Magnesium: Mg
Chromium: Cr
Osmium: Os
Rhenium: Re
Palladium: Pd
Ruthenium: Ru

Tantalum Hafnium Carbide: Ta4HfC5
Cermet
Boron Nitride: BN
Yttrium: Y
Europium: Eu
Manganese: Mn

Copper Oxide (YBCO): YBa2Cu3O7
Beryllium Oxide: BeO
Aluminum Oxide: Al2O3
Yttrium Barium Copper Oxide: YBa2Cu3O7
Tungsten-Lanthanum Oxide: W-La2O3
Zinc Oxide: ZnO
Yttrium Barium Copper Oxide: YBa2Cu3O7

Magnesium Diboride: MgB2
Zirconium Diboride: ZrB2
Zirconium Carbide: ZrC
Silicon Carbide: SiC
Vanadium Carbide: VC
Chromium Carbide: Cr3C2
Tungsten Carbide: WC
Tantalum Carbide: TaC

Boron Nitride: BN
Silicon Nitride: Si3N4
Titanium Nitride: TiN
Aluminum Nitride: AlN

Samarium-Cobalt Magnet: SmCo
Samarium Titanate: Sm2Ti2O7
Nitinol: NiTi

Silicon-Graphite Composites
Carbon-Fiber-Reinforced

Molybdenum: Mo
Thorium: Th
Americium: Am
Samarium: Sm
Boron: B
Deuterium: D
Tritium: T
Berkelium: Bk
Lithium-4/6/7: Li-4/6/7
Helium-3/4: He-3/4
Niobium: Nb

Niobium-Titanium Superconductor: Nb-Ti
Tantalum-Hafnium-Carbide Composite: Ta-Hf-C
Titanium-Silicon Carbide Composite: Ti-SiC
Lanthanum Hexaboride: LaB6
Tungsten-Lanthanum Oxide Composite: W-La2O3
Samarium-Cobalt Magnet: SmCo

Beryllium: Be
Tungsten: W
Molybdenum: Mo
Graphene
Titanium: Ti
Iron: Fe
Ceramics
Copper: Cu
Stainless Steel
Nickel: Ni
Titanium Aluminides
Alumina: Al2O3
TZM

Hastelloy alloys
Copper-Chromium Alloy
Tungsten-Titanium Alloy
Tungsten-Copper Alloy
Tungsten-Rhenium Alloy
Tungsten-Zirconium Alloy
Tantalum-Lithium Alloy
Nickel-Based Superalloys
Nickel-Titanium (Ni-Ti) Alloy
Cobalt-Chromium (Co-Cr) Alloy
Titanium-Aluminum (Ti-Al) Alloy
Platinum-Rhodium (Pt-Rh) Alloy
Tungsten-Rhenium-Iridium (W-Re-Ir) Alloy
Nickel-Chromium (Ni-Cr) Alloy
Lead-Lithium (Pb-Li) Eutectic Alloy
Silicon-Aluminum (Si-Al) Alloy
Titanium-Zirconium-Molybdenum (TZM) Alloy
Copper-Chromium-Zirconium (Cu-Cr-Zr) Alloy
Molybdenum-Tungsten (Mo-W) Alloy
Lithium-Lithium Aluminum Alloy (Li-LiAl)
Uranium Alloy-1/2/3
Zirconium alloys
Nitinol (Nickel-Titanium)
Lead-Lithium Alloy
